11111111111111111111111111
1P0C0010000C00000000000001
11010010000000000C0000C001
10000010000C00111111111101
100000C0000000000C10000001
100000C00000E0000C00000001
100000C0000000000C00000001
11111111111111111111111111
