11111111111111111
100A00000000EA001
100000000C00A00A1
1PA00A00011111111
11111111111111111
